+---+---+---+---+---+---+---+---+---+---+---+---+---+---+---+---+---+---+---+---+---+---+---+---+---+---+---+---+---+---+---+---+
|                                                                                                                               |
+   +---+---+---+---+---+---+---+   +---+---+---+---+---+---+   +---+   +   +---+   +---+---+   +---+---+---+   +---+---+   +   +
|   |                           |   |               |       |       |   |   |           |       |                   |       |   |
+   +   +---+   +---+   +---+   +   +   +---+   +   +   +   +---+   +   +   +---+---+   +   +---+   +   +---+---+   +   +---+   +
|   |   |           |           |   |   |       |   |   |       |       |           |       |       |       |   |   |   |   |   |
+   +   +---+   +---+   +---+   +   +   +   +---+   +   +   +   +---+   +---+   +   +---+---+   +---+---+   +   +   +   +   +   +
|   |               |       |   |   |   |   |       |   |   |       |       |   |   |           |       |   |       |   |       |
+   +---+   +---+   +---+   +   +   +   +   +---+---+   +   +---+   +---+   +   +   +   +---+---+   +   +   +---+   +   +---+---+
|       |       |       |   |   |   |   |           |           |       |       |   |               |   |       |   |   |       |
+---+   +---+   +---+   +   +   +   +   +---+   +   +---+---+   +---+   +---+   +   +   +---+   +   +   +---+   +   +   +   +   +
|       |   |       |   |   |   |   |       |   |       |       |   |       |   |   |       |   |   |           |   |   |   |   |
+   +---+   +---+   +   +   +   +   +---+   +   +---+   +   +---+   +   +   +   +   +---+   +   +   +   +---+   +   +   +   +   +
|   |                   |   |   |   |   |           |   |   |       |   |   |           |   |           |       |   |   |   |   |
+   +---+---+---+---+   +   +---+   +   +---+---+   +   +   +   +   +   +   +   +   +   +   +   +   +   +   +   +   +   +   +   +
|                   |   |   |       |       |       |   |   |   |   |           |   |       |   |   |       |   |   |   |   |   |
+---+---+---+---+   +---+   +   +---+   +---+   +   +   +   +   +   +---+---+---+---+   +---+   +   +   +   +   +   +   +   +   +
|               |           |   |       |       |   |   |   |   |                   |           |       |           |   |   |   |
+   +---+---+   +---+   +---+   +---+   +   +---+   +   +   +   +---+   +---+---+   +---+---+---+   +---+   +---+   +   +   +   +
|   |   |       |       |       |       |   |       |   |   |   |                                                   |   |   |   |
+   +   +   +---+   +---+   +---+   +   +   +   +   +   +   +---+   +---+---+---+---+---+---+---+---+---+---+---+   +   +   +   +
|   |       |       |       |       |   |   |   |   |   |   |       |                                           |       |   |   |
+   +   +---+   +---+   +---+   +---+   +   +   +---+   +   +   +---+   +---+---+---+---+---+---+---+---+---+   +---+---+   +   +
|   |   |       |       |               |   |   |       |   |   |       |                   |               |               |   |
+   +---+   +---+   +---+   +---+   +---+   +   +   +---+   +   +   +---+   +---+   +---+   +   +---+---+---+---+---+---+---+   +
|   |       |       |       |           |   |   |   |       |       |           |   |           |                               |
+   +   +---+   +---+   +---+---+   +---+   +   +   +   +---+   +---+---+---+---+   +---+---+---+   +---+---+---+---+---+---+   +
|       |                                       |   |   |       |                   |               |                       |   |
+   +---+   +---+---+---+---+---+---+---+---+---+   +   +   +   +   +---+---+---+   +   +---+---+---+   +---+---+---+---+   +   +
|   |       |                                       |   |   |                       |       |                           |   |   |
+---+   +---+   +---+---+---+---+---+---+---+---+---+   +   +   +---+---+---+---+   +---+   +---+---+---+---+   +---+   +---+   +
|       |                                           |   |   |                           |                   |       |       |   |
+   +---+   +---+---+---+---+---+---+---+---+---+   +   +   +---+---+---+---+---+---+   +---+---+---+---+   +   +---+---+   +   +
|   |   |   |                           |           |   |                               |               |                       |
+   +   +   +---+   +---+---+---+   +---+   +---+   +   +---+---+---+---+---+---+---+   +   +   +---+   +---+---+---+   +---+   +
|   |   |       |                   |       |   |   |       |                   |   |   |   |   |   |       |       |       |   |
+   +   +---+   +---+---+   +   +---+   +---+   +   +---+   +   +   +---+---+   +   +   +   +   +   +---+   +---+   +   +   +---+
|   |       |           |   |   |       |               |   |   |   |       |       |   |   |   |               |       |       |
+   +   +   +---+   +   +   +   +   +---+---+---+   +---+   +   +   +   +   +---+   +   +---+   +   +---+---+   +---+   +---+   +
|   |   |       |   |           |                           |   |   |   |   |       |       |   |                               |
+   +   +---+   +   +---+---+   +---+---+---+---+---+---+---+---+   +   +---+   +---+---+   +   +---+---+---+---+---+---+   +   +
|   |   |   |       |       |   |                                   |                   |   |                           |   |   |
+   +   +   +---+   +---+   +   +   +   +   +---+---+---+---+---+   +---+---+---+---+---+   +   +---+---+---+---+---+   +---+   +
|   |   |       |               |   |   |       |                   |                       |       |               |       |   |
+   +   +   +---+---+   +---+   +   +   +---+   +---+---+---+---+   +   +---+---+---+---+---+---+   +---+   +---+---+---+   +   +
|   |   |               |       |           |                                                           |               |   |   |
+   +   +   +---+---+---+   +---+   +---+   +---+---+---+---+---+---+---+---+---+---+---+   +---+   +   +---+   +---+   +   +   +
|   |   |   |               |                                   |           |                   |   |       |   |       |   |   |
+   +   +   +   +---+---+---+---+---+---+---+---+---+---+---+---+   +---+   +   +---+   +---+   +   +---+   +   +   +---+   +   +
|   |   |   |   |                                                   |       |           |   |   |                   |       |   |
+   +   +   +   +   +---+---+---+---+---+---+---+---+---+---+---+---+   +---+   +---+   +   +   +---+---+---+---+---+   +---+   +
|   |   |   |   |   |                                               |   |           |                                   |       |
+   +   +   +   +   +   +---+---+   +---+---+---+---+---+---+   +---+   +   +---+   +---+---+   +---+---+---+---+---+---+   +   +
|   |   |   |   |   |   |                                       |       |               |       |                           |   |
+   +   +   +   +   +   +   +---+   +---+   +---+   +---+   +---+   +---+   +---+---+   +   +---+   +---+---+---+---+---+---+   +
|   |   |   |   |   |   |       |   |               |       |       |       |       |       |       |                           |
+   +   +   +   +   +   +---+   +   +   +---+---+   +   +---+   +---+   +---+   +   +---+   +   +---+   +---+---+   +   +---+   +
|   |   |   |   |   |           |   |                   |       |       |       |       |   |   |                   |       |   |
+   +   +---+   +   +---+---+   +   +---+---+---+---+---+   +---+   +   +   +---+---+   +---+   +   +---+---+---+   +---+   +   +
|   |   |       |               |   |                       |       |       |       |           | G                     |   |   |
+   +   +   +---+   +   +---+   +   +   +---+---+---+---+---+---+   +   +---+   +   +---+---+---+---+---+---+---+---+---+   +   +
|   |               |       |       |                                   |       |                                           |   |
+   +   +---+---+---+---+   +   +---+   +---+---+---+---+   +---+---+---+   +---+   +---+---+---+---+---+---+---+---+---+---+   +
| S |                       |                                                   |                                               |
+---+---+---+---+---+---+---+---+---+---+---+---+---+---+---+---+---+---+---+---+---+---+---+---+---+---+---+---+---+---+---+---+
