+---+---+---+---+---+---+---+---+---+---+---+---+---+---+---+---+---+---+---+---+---+---+---+---+---+---+---+---+---+---+---+---+
|                                                                                                                   |           |
+   +   +---+---+---+   +---+---+---+---+---+---+---+---+---+---+---+---+   +---+---+   +   +---+---+---+---+---+   +   +   +   +
|   |       |       |       |                                       |   |       |       |       |               |   |   |   |   |
+   +   +---+   +   +   +   +---+   +---+---+---+---+---+---+   +   +   +---+   +   +---+---+   +   +   +---+---+   +   +   +   +
|               |       |       |                       |       |       |   |   |   |       |   |   |       |       |   |   |   |
+   +---+   +---+---+   +---+   +   +---+---+---+---+---+   +---+---+   +   +   +   +   +   +   +---+   +   +   +---+   +   +   +
|   |       |       |       |                               |               |   |   |   |   |       |   |       |       |   |   |
+   +   +---+---+   +---+   +---+---+---+---+---+---+---+---+---+---+   +---+   +   +   +   +---+   +   +   +---+   +   +   +   +
|       |                                                                       |   |   |   |   |       |   |       |   |   |   |
+   +---+   +   +---+---+---+---+---+---+---+---+---+   +---+---+---+---+---+   +   +   +   +   +---+   +---+   +---+   +   +   +
|   |   |   |                                           |       |           |   |   |   |           |           |               |
+   +   +   +---+---+---+---+---+   +   +---+---+   +---+   +   +   +---+   +   +   +   +---+---+---+---+---+---+   +---+---+   +
|   |   |   |               |       |               |       |   |   |   |   |   |   |   |                                   |   |
+   +   +   +---+   +   +   +---+   +---+---+---+---+   +---+   +   +   +   +   +   +   +   +---+---+---+---+---+---+---+   +   +
|   |   |       |   |   |                       |       |   |   |       |   |   |   |       |                           |   |   |
+   +   +---+   +---+   +---+---+---+---+---+   +   +---+   +   +   +---+   +   +   +   +---+   +---+---+---+   +   +---+   +   +
|   |               |       |                   |   |       |   |   |       |   |   |   |   |   |           |   |   |       |   |
+   +   +---+---+   +---+   +---+---+---+---+---+   +---+   +   +---+   +   +   +   +   +   +   +   +---+   +   +---+   +   +   +
|   |                   |                       |       |   |   |       |   |   |   |   |   |   |   |       |   |       |   |   |
+   +   +   +---+---+   +   +---+---+---+---+   +   +   +   +   +   +---+   +   +   +   +   +   +   +   +---+   +   +   +   +   +
|   |   |           |   |                   |       |   |   |   |   |       |   |   |   |   |   |   |   |       |   |   |   |   |
+   +   +---+   +---+   +---+---+---+---+---+---+   +   +   +   +   +---+   +   +   +   +   +   +   +   +   +   +   +   +   +   +
|   |       |                                       |       |   |       |   |   |   |           |   |       |   |   |   |   |   |
+   +---+---+---+---+---+---+---+---+---+---+---+---+---+   +   +   +   +   +   +   +   +---+   +   +   +---+   +   +   +   +   +
|   |                                                       |   |   |   |   |   |   |       |   |   |   |       |   |   |   |   |
+   +   +---+---+---+---+---+---+---+---+---+---+---+---+---+   +   +   +   +   +   +---+   +   +   +   +   +---+   +   +   +   +
|   |   |                                   |                   |   |   |   |   |       |   |       |   |       |           |   |
+   +   +   +---+---+   +---+---+---+   +---+   +---+---+---+---+   +   +   +   +---+   +   +---+   +   +   +---+   +   +   +   +
|   |   |   |                   |       |                           |   |   |   |   |   |       |   |   |   |       |   |       |
+   +   +   +---+   +   +---+---+   +---+   +   +---+---+---+---+   +   +   +   +   +   +---+   +---+   +---+   +   +---+   +   +
|   |   |       |   |       |       |       |                           |   |   |   |   |               |       |   |       |   |
+   +   +---+   +   +   +   +   +---+   +---+   +---+---+---+---+---+---+---+   +   +   +---+---+---+---+   +   +   +   +---+   +
|   |       |       |   |   |       |       |                                       |               |       |   |   |   |   |   |
+   +---+   +---+   +---+   +---+   +---+   +   +---+---+---+---+---+---+---+---+---+---+---+---+   +   +---+   +   +   +   +   +
|       |       |               |       |   |                       |                           |       |       |   |   |       |
+   +   +---+   +---+---+---+   +---+   +   +---+---+---+---+   +---+   +---+---+---+---+   +   +---+---+---+   +   +   +   +---+
|   |               |               |   |   |           |   |   |       |                   |               |   |   |   |       |
+   +   +   +---+   +---+---+   +---+   +   +   +---+   +   +   +   +---+---+---+---+---+   +   +---+---+   +   +   +   +---+   +
|   |   |   |   |                       |   |   |   |           |       |                   |       |   |       |   |       |   |
+---+   +   +   +---+---+---+---+---+   +   +   +   +   +---+   +   +   +   +---+---+---+   +---+   +   +---+   +   +---+   +---+
|       |                           |   |   |           |       |   |       |           |       |   |       |   |   |   |       |
+   +---+   +---+---+---+   +---+   +   +   +   +---+   +   +---+   +---+---+---+---+   +---+   +   +   +   +   +   +   +   +   +
|                                   |   |   |                                           |       |   |   |   |   |   |       |   |
+   +---+---+---+---+---+---+---+---+   +   +---+---+---+---+---+---+---+---+---+---+---+   +---+   +   +   +   +   +   +   +   +
|                                       |                                                       |   |   |   |   |   |   |   |   |
+   +---+---+---+---+---+---+---+   +---+---+---+---+---+---+---+---+---+---+---+---+---+---+---+   +   +   +   +   +   +   +   +
|       |                       |                                                           |       |   |       |   |   |   |   |
+   +---+   +---+---+---+---+   +---+---+---+---+---+---+---+---+---+---+---+---+---+---+   +   +---+   +---+---+   +---+   +   +
|   |       |       |       |           |                                               |   |                               |   |
+   +   +---+   +   +---+   +---+---+   +   +---+---+---+---+   +---+---+---+---+---+   +   +---+---+---+---+---+---+---+---+   +
|   |   |       |               |       |   |               |                   |       |   |                       |           |
+   +   +   +---+---+---+---+---+   +---+   +---+---+---+   +---+---+---+---+   +---+   +   +---+---+---+---+---+   +   +   +   +
|       |       |                   |                               |       |       |                               |   |   |   |
+   +---+---+   +   +---+---+---+---+---+---+---+---+---+---+---+---+   +   +---+   +   +---+---+---+---+---+---+---+   +   +   +
|   |           |   |                                                   |       |       |                           |   |       |
+   +   +   +---+   +---+   +---+---+---+---+---+---+---+---+---+---+---+---+   +---+---+   +---+---+---+---+---+   +   +---+   +
|   |   |   |       |       |   |                                           |       |       |                       |       |   |
+   +   +   +   +---+   +---+   +   +---+---+---+---+   +---+---+---+---+   +---+   +   +---+   +---+---+---+---+---+---+   +   +
|   |           |       |                         G |   |                       |       |                                   |   |
+   +   +---+---+   +---+---+---+---+---+---+---+---+   +   +---+---+---+   +---+---+---+   +---+---+---+---+---+---+   +---+   +
|   |               |                                   |       |                       |                               |   |   |
+   +   +---+   +---+   +---+---+---+---+---+---+---+---+   +---+   +---+---+---+---+   +---+---+---+---+---+---+---+---+   +   +
| S |           |                                                                                                               |
+---+---+---+---+---+---+---+---+---+---+---+---+---+---+---+---+---+---+---+---+---+---+---+---+---+---+---+---+---+---+---+---+
