+---+---+---+---+---+---+---+---+---+---+---+---+---+---+---+---+---+---+---+---+---+---+---+---+---+---+---+---+---+---+---+---+
|                                       |                                   |                       |                           |
+   +---+   +---+---+   +---+---+---+   +---+   +---+   +---+   +   +---+   +   +---+---+---+---+   +   +   +---+   +---+   +   +
|   |       |       |   |                   |           |       |       |       |                   |   |   |           |   |   |
+   +   +---+---+   +   +---+   +---+   +   +   +   +   +   +---+---+   +---+---+   +---+---+   +---+   +   +---+---+   +---+   +
|       |           |       |           |       |   |               |                   |       |       |                       |
+   +---+---+   +   +---+   +---+---+   +---+   +   +   +---+---+   +---+---+   +---+   +   +---+---+---+---+   +---+---+---+   +
|   |           |                   |           |       |                   |       |                       |       |       |   |
+   +   +   +---+   +---+---+---+   +---+   +---+   +---+   +---+---+---+   +---+   +---+---+---+---+---+   +---+   +   +   +   +
|   |   |       |   |                   |   |               |           |       |       |                       |   |   |       |
+   +---+   +   +---+   +   +---+---+   +   +   +---+   +   +   +---+   +---+   +---+   +---+   +   +---+---+   +   +   +   +   +
|       |   |           |                   |           |   |   |   |       |       |       |   |                   |   |   |   |
+   +   +   +---+---+---+---+   +---+---+   +   +---+---+   +   +   +   +---+---+   +---+   +   +---+   +---+---+   +   +   +   +
|   |   |   |                           |   |       |       |       |                   |   |       |               |           |
+   +   +   +   +---+   +---+---+   +---+   +---+   +   +   +---+   +---+   +---+---+   +   +---+   +---+---+---+---+   +---+   +
|   |   |   |                   |       |       |       |       |       |               |   |   |                       |       |
+   +   +   +---+   +---+   +---+---+   +---+   +---+---+   +---+   +---+---+---+   +---+   +   +---+   +---+   +---+---+   +   +
|   |   |       |   |       |       |       |               |       |           |   |       |   |       |                   |   |
+   +   +---+   +---+   +---+   +   +---+   +   +---+   +---+   +---+   +   +   +---+   +---+   +   +---+   +---+---+   +---+   +
|   |                   |       |           |           |       |       |   |       |       |       |                   |       |
+   +   +---+---+   +---+   +---+---+---+   +   +   +---+   +---+   +---+   +---+   +---+   +---+   +   +---+---+   +---+   +---+
|   |       |       |       |       |       |   |   |       |   |   |           |       |       |                   |   |   |   |
+   +---+   +---+---+   +---+   +   +   +---+   +   +   +   +   +   +   +   +   +---+   +---+   +   +---+---+   +---+   +   +   +
|       |       |       |       |       |       |       |           |   |   |       |       |       |   |       |           |   |
+   +   +---+   +   +---+---+---+---+---+   +   +   +---+   +---+   +   +   +---+---+---+   +   +   +   +   +---+   +   +   +   +
|   |       |   |                   |       |   |       |   |       |       |           |   |   |                   |   |   |   |
+   +---+   +   +   +---+---+   +   +   +   +   +---+   +   +   +---+   +---+   +---+   +   +   +   +---+   +   +   +---+   +   +
|   |       |   |   |       |   |   |   |   |       |       |   |                   |   |   |   |       |   |   |   |       |   |
+   +   +   +   +---+   +   +---+   +   +   +---+   +---+   +   +---+---+---+---+---+   +   +   +---+   +   +   +   +   +---+   +
|   |   |       |       |       |   |   |       |       |   |                       |   |   |       |   |       |               |
+   +---+   +---+   +---+---+   +   +   +---+   +---+   +   +---+---+---+---+---+   +   +   +---+   +   +---+   +---+---+---+   +
|   |       |                   |   |                   |   |                   |   |   |   |   |           |               |   |
+   +   +---+   +---+   +---+   +   +---+   +---+---+---+   +---+---+---+   +---+   +   +   +   +---+---+   +---+---+---+   +   +
|       |       |   |       |       |   |                                   |       |   |   |       |   |   |           |   |   |
+   +---+   +---+   +---+   +---+   +   +---+---+---+---+---+---+---+---+---+   +---+   +   +   +   +   +   +   +---+   +   +   +
|   |       |       |   |       |                                       |       |       |   |   |           |   |       |   |   |
+   +   +---+   +   +   +---+   +---+   +---+   +---+---+---+---+---+   +   +---+   +   +   +   +   +---+   +---+   +   +   +   +
|   |   |       |           |           |       |               |   |       |       |   |   |   |   |       |       |   |   |   |
+   +   +   +---+---+---+   +   +   +   +   +---+   +   +---+   +   +---+---+   +---+   +   +   +   +   +   +   +---+   +   +   +
|   |               |       |   |   |       |       |               |           |   |   |   |   |       |       |       |   |   |
+   +---+---+   +   +   +---+   +---+   +---+   +---+   +---+   +   +---+   +---+   +   +   +   +   +---+   +---+---+   +   +   +
|   |       |   |       |       |       |           |       |   |       |       |   |   |   |                       |   |   |   |
+   +   +   +---+---+---+   +---+   +---+---+---+---+---+   +   +---+   +---+   +   +   +   +   +---+---+---+---+   +---+   +   +
|   |   |                   |       |                       |               |           |   |                   |       |   |   |
+   +   +   +---+---+---+---+   +---+   +---+---+---+---+---+   +   +---+   +---+   +   +   +   +---+---+---+   +---+   +   +   +
|   |   |   |                   |                       |       |       |       |   |   |   |   |           |   |       |   |   |
+   +   +   +   +---+---+---+---+   +---+---+---+---+   +---+   +---+---+---+   +   +   +   +---+   +---+   +   +   +---+   +   +
|       |       |           |       |               |       |                   |   |   |           |   |   |       |       |   |
+   +---+   +---+   +---+   +   +---+   +   +---+   +---+   +   +---+---+   +---+---+   +---+---+---+   +   +   +---+   +   +   +
|   |       |       |   |   |   |       |   |       |       |   |       |   |               |           |   |   |       |   |   |
+   +   +---+   +---+   +   +   +---+---+   +---+---+   +   +---+   +   +   +---+   +---+   +   +---+   +   +---+   +---+   +   +
|       |       |       |   |       |       |           |   |       |   |       |       |   |           |   |       |           |
+   +---+   +   +---+   +   +---+   +   +---+   +---+   +   +   +---+   +---+   +---+   +---+   +---+   +   +   +---+   +---+   +
|   |       |       |       |           |               |       |   |   |   |       |           |       |   |       |       |   |
+   +---+   +   +   +---+---+   +---+---+   +---+---+   +   +---+   +   +   +---+   +---+---+---+   +   +   +---+   +---+   +   +
|   |       |   |                   |       |       |       |       |   |                           |   |       |               |
+   +   +   +---+---+---+---+---+---+   +---+   +   +   +---+   +---+   +   +---+---+---+---+---+   +---+---+   +---+   +---+   +
|   |   |                               |       |       |       |       |               |           |       |       |       |   |
+   +   +---+   +---+---+---+   +   +---+   +---+---+---+   +   +   +---+   +---+   +   +---+   +---+   +   +---+   +---+   +---+
|   |   |       |       |       |   |       |       |       |   |       |   |       |       |   |       |       |       |       |
+   +   +---+---+   +   +---+   +   +   +---+   +---+   +---+   +---+   +---+   +---+---+   +---+   +---+   +   +---+   +---+   +
|   |   |           |               |                   |       | G |       |   |       |           |       |               |   |
+   +   +   +---+---+---+   +---+---+---+   +---+---+---+   +   +   +---+   +   +   +   +---+---+---+---+   +   +---+---+   +   +
| S |                                                       |           |           |                                           |
+---+---+---+---+---+---+---+---+---+---+---+---+---+---+---+---+---+---+---+---+---+---+---+---+---+---+---+---+---+---+---+---+
